11111111111111111111111111111
100000000000000000000000000E1
101000C00000000C0000000111111
1P101111111111111111110111011
1PP10000000C00000000000111111
11111111111111111111111111111