11111111111111111111111111111
10000000000000C0000000000E001
101000C00000000C0000000111111
10101111111111111111110111111
1P110000000C00000000000111111
11111111111111111111111111111