11111111111111111111111111111
111000000000000000000000000E1
111000C00000000C0000000111111
11111111111111111111110111111
1P000000000C00000000000111111
11111111111111111111111111111