11111111111111111111111111111111111111111111111111111111111111111111111111111111111
10000000000000000000000000000000C00000000000000000000000000000000000000000000000001
10011100000C001111111111100011100000011100000111000001110000000000000000C0000000001
10011100000000110000000000000111000011100000001110001110000111111111110000000000001
10011100000000111110000000000011100111000000000111E11100000000001111110000000000001
100111000P0000111110000000000001111110000000000011111000000000000000000000000000001
10011100000000110000000000000011111111000000000011110000000000000000000000000000001
100111111111001111111111100001110000111000C0000011110000000000000000000000000000001
10011111111100111111111110001110000001110000000011110000000000000000000000000000001
10000000000000000000000000000000000000C000000000000000000000000000000000C0000000001
100000000000C0000000000000000000000000000000000000000000000000000000000000000000001
11111111111111111111111111111111111111111111111111111111111111111111111111111111111