111111111111111111111111111111111111111111
100000000000000000000000000C00000000000001
101100000C11111111000110000110001100001101
101100000011C0000000001100110000011E011001
101100000011111000000001111000000011110001
1011000P0011111000000000110000000001100001
1C1100000011000000000001111000000001100001
101111111011111111000011C0110C000001100001
101111111011111111000110000110000001100001
100000000000000000000000000000000C00000001
1000000000C0000000000000000000000000000001
111111111111111111111111111111111111111111