11111
10PE1
111C1
11111
11111
11111