11111111111111111111111
1P00C0C000C000000000E01
1000C000C00000C00000001
11111111111111111111111