111111111111111111111111
110001011111011101010001001
10000000000000100000000100
1111111111111111111111111111