111111111111111111111111111111111111111
111C011000000C0000110011000000000000C01
1P1000C001110011100C000001110C000010001
111000000000001010000000001C100000E0001
111111111111111111111111111111111111111