111111111111111111111111111111111111111
100C011000000C0000110011000000000000C01
1P0000C001110000000C000001110C000111001
10000000000000000000000000C1000001E1001
111111111111111111111111111111111111111