111111111111111111111111111111111111111
111C011000000C0000110011000000000000C01
1P1000C001110000000C000001110C000010001
11100000000000000000000001C100000E00001
111111111111111111111111111111111111111