111111111111111111111111111111111111111
100C0 1000000C0000110011000000000000C01
1P00 0C001110000000C000001110C000010001
1000000000000000000E000001C100000000001
111111111111111111111111111111111111111