111111111111111111111111111111111111111
100001100000000000110011000000000000E01
1P0000000111000000000000000000000010001
111111111111111111111111111111111111111